####         ##
##   #######    ##
#  ###########  ###
#  A#B           #
######
