#A## ###   #########B           #          #
# ##     # ##      ###   ######## ## #######
# ####  ## ####### ####           ##       #
#    ##  #       #    ########### ##########
#### #  ######## #### #####                #
   # ##       ## ####     ################ #
 #   ######## ## ########      ########### #
 #####     ##  #        ###### ##       ## #
    ## ### ## ## ###### ###### ########    #
 ## ## #      ###                       ## #
#   ## #####################################
  ###                                      #
 ######################################### #
                                           #
