##### #
##### #
####  #
#### ##
     ##
A######

##### #
#######
#######
#######
#######
#######

##### #
##### #
####  #
#### ##
     ##
B######
