#              #   #
# ############ ## ##
#         B# # ## ##
###### ### # #  # ##
##   # ### # ## # ##
#  # # #        # ##
# ##   ### #### # ##
     ##     ### # ##
### ####### ### # ##
A           ###   ##
