##########
###     ##
### ### ##
#   ### ##
#A###   ##
##########

##########
##########
##########
##########
##    ####
## #######

        ## 
 ###### ##
 ###### ##
 ###### ##
 #########
   #######


##########
##########
##########
##########
##########
###B     #

         #
 ####### #
 ####### #
    #### #
######## #
######## #

##########
###   ####
### # ####
### # # ##
##### # ##
#####   ##
